Type,Product,Started Date,Completed Date,Description,Amount,Fee,Currency,State,Balance
CARD_PAYMENT,Current,2024-01-08 20:18:47,2024-01-09 11:58:22,Shop,-13.27,0.00,EURO,COMPLETED,19.79
CARD_PAYMENT,Current,2024-01-09 20:02:00,2024-01-10 02:53:12,Texts,-4.59,0.00,EURO,COMPLETED,15.20
CARD_PAYMENT,Current,2024-01-23 05:03:09,2024-01-23 14:32:20,Discord,-9.99,0.00,EURO,COMPLETED,5.21
CARD_PAYMENT,Current,2024-02-09 21:02:00,2024-02-10 02:54:12,Texts,-4.56,0.00,EURO,COMPLETED,0.56
TOPUP,Current,2024-02-10 02:54:12,2024-02-10 02:54:12,Shop Pay Topup,20.00,0.00,EURO,COMPLETED,20.56
TOPUP,Current,2024-02-10 03:54:12,2024-02-10 03:54:12,Shop Pay Topup,20.00,0.00,EURO,COMPLETED,40.56
TOPUP,Current,2024-02-10 04:54:12,2024-02-10 04:54:12,Shop Pay Topup,20.00,0.00,EURO,COMPLETED,60.56
